..#########################################################
....#.#...#.#...#.......#.....#...#...#.#.#.#.......#.....#
#.#.#.###.#.#.###.###.###.#.#.#.#####.#.#.#.#####.#.###.###
#.#...........#...#.#.#.#.#.#.....#.....#.....#...#...#...#
#####.###.###.#.###.###.#########.###.#####.#######.###.###
#.#.....#...#.........#...#.....#.#...#...#...#...........#
#.#.#######.###.#.#######.#.#####.###.#.#.#.###.#########.#
#.....#...#.#...#.#.....#...............#.#.#.#.........#.#
#####.###.#######.###.#########.#######.#.#.#.###.###.#.#.#
#.......#.#.....#.#.........#...#.#.....#...#.....#...#.#.#
#.###.#.#.###.###########.#####.#.#####.#.###.###.#######.#
#...#.#.....#...............#.....#...#.#.....#.....#.....#
###.#####.#.#.###.#########.#.#######.#######.#####.#.###.#
#.......#.#...#.....#.......#.#...#.......#.#...#.#.#.#...#
#####.###.#.###.#.#.#######.#.#.#.#.#####.#.#.###.#########
#.#.#.#.#.#.#...#.#.#...#.#.....#.#.....#.#.....#...#...#.#
#.#.###.#.#.#.###.#####.#.#####.###.#####.#######.#####.#.#
#.........#.#.#.#.#...#.#.#...#.....#.....#.#.#.....#.#.#.#
###.#.#.###.###.###.#.#.#.#.#####.###.#.#.#.#.#.#####.#.#.#
#.#.#.#...#.........#.#...#...#...#.#.#.#.#.#.....#.....#.#
#.#.#.###.#####.#.#####.#.#.###.###.#####.#.#.###.###.###.#
#...#.#...#.....#...#...#.....#.......#.#.#.#...#.#.......#
###.###.###.###.###.###.###.#####.###.#.###.###.#######.#.#
#.....#...#...#...#.......#.#.......#.#...#.....#.......#.#
#.#####.#########.###########.#.#.###.#.#######.#.#.#.#.###
#.#.......#.#.....#.#.#...#...#.#.#...#.#...#.....#.#.#.#.#
#.#.#.#.#.#.#####.#.#.#.###.#######.###.#.#.#.#####.###.#.#
#.#.#.#.#.#.....#.#.#.#...#.......#.....#.#...#.#.#...#...#
###.###########.#.#.#.#.###.#######.#######.#.#.#.#.###.###
#.....#.#.....#.......#.#.#...#.#.#.#...#...#...#.....#...#
#.#.###.#.#######.#.###.#.#####.#.###.#########.#####.#.###
#.#...#...........#.....#.........#...#...........#.#.#...#
#######.###.###.#########.#.#.#######.#.#.#.#####.#.#####.#
#.#.....#.#.#.......#.#...#.#.....#.....#.#.....#.#...#.#.#
#.###.###.#########.#.#########.###.#.###.#.#.###.#.###.#.#
#...........#.#.......#...........#.#.#...#.#.#...#...#.#.#
###.###.#####.#.###########.#.#.#.#.#########.#.#.###.#.#.#
#...#.#.......#.....#...#.#.#.#.#.....#.#...#.#.#.....#...#
#####.#######.###.#####.#.#.#.#####.#.#.###.#######.###.###
#.#...#.......#.......#.....#...#...#.....#.....#...#.....#
#.#.#######.###.#####.#.###########.#.###.#####.###.#####.#
#.....#.......#.....#...#...#.......#.#.......#.........#.#
#.###.#####.#####.#.#######.###.#.###.###.#.#####.#######.#
#.#.............#.#.#...........#.#.....#.#...#.....#
#########################################################

..#########################################################
....#.#...#.#...#.......#.....#...#...#.#.#.#.......#.....#
#.#.#.###.#.#.###.###.###.#.#.#.#####.#.#.#.#####.#.###.###
#.#...........#...#.#.#.#.#.#.....#.....#.....#...#...#...#
#####.###.###.#.###.###.#########.###.#####.#######.###.###
#.#.....#...#.........#...#.....#.#...#...#...#...........#
#.#.#######.###.#.#######.#.#####.###.#.#.#.###.#########.#
#.....#...#.#...#.#.....#...............#.#.#.#.........#.#
#####.###.#######.###.#########.#######.#.#.#.###.###.#.#.#
#.......#.#.....#.#.........#...#.#.....#...#.....#...#.#.#
#.###.#.#.###.###########.#####.#.#####.#.###.###.#######.#
#...#.#.....#...............#.....#...#.#.....#.....#.....#
###.#####.#.#.###.#########.#.#######.#######.#####.#.###.#
#.......#.#...#.....#.......#.#...#.......#.#...#.#.#.#...#
#####.###.#.###.#.#.#######.#.#.#.#.#####.#.#.###.#########
#.#.#.#.#.#.#...#.#.#...#.#.....#.#.....#.#.....#...#...#.#
#.#.###.#.#.#.###.#####.#.#####.###.#####.#######.#####.#.#
#.........#.#.#.#.#...#.#.#...#.....#.....#.#.#.....#.#.#.#
###.#.#.###.###.###.#.#.#.#.#####.###.#.#.#.#.#.#####.#.#.#
#.#.#.#...#.........#.#...#...#...#.#.#.#.#.#.....#.....#.#
#.#.#.###.#####.#.#####.#.#.###.###.#####.#.#.###.###.###.#
#...#.#...#.....#...#...#.....#.......#.#.#.#...#.#.......#
###.###.###.###.###.###.###.#####.###.#.###.###.#######.#.#
#.....#...#...#...#.......#.#.......#.#...#.....#.......#.#
#.#####.#########.###########.#.#.###.#.#######.#.#.#.#.###
#.#.......#.#.....#.#.#...#...#.#.#...#.#...#.....#.#.#.#.#
#.#.#.#.#.#.#####.#.#.#.###.#######.###.#.#.#.#####.###.#.#
#.#.#.#.#.#.....#.#.#.#...#.......#.....#.#...#.#.#...#...#
###.###########.#.#.#.#.###.#######.#######.#.#.#.#.###.###
#.....#.#.....#.......#.#.#...#.#.#.#...#...#...#.....#...#
#.#.###.#.#######.#.###.#.#####.#.###.#########.#####.#.###
#.#...#...........#.....#.........#...#...........#.#.#...#
#######.###.###.#########.#.#.#######.#.#.#.#####.#.#####.#
#.#.....#.#.#.......#.#...#.#.....#.....#.#.....#.#...#.#.#
#.###.###.#########.#.#########.###.#.###.#.#.###.#.###.#.#
#...........#.#.......#...........#.#.#...#.#.#...#...#.#.#
###.###.#####.#.###########.#.#.#.#.#########.#.#.###.#.#.#
#...#.#.......#.....#...#.#.#.#.#.....#.#...#.#.#.....#...#
#####.#######.###.#####.#.#.#.#####.#.#.###.#######.###.###
#.#...#.......#.......#.....#...#...#.....#.....#...#.....#
#.#.#######.###.#####.#.###########.#.###.#####.###.#####.#
#.....#.......#.....#...#...#.......#.#.......#.........#.#
#.###.#####.#####.#.#######.###.#.###.###.#.#####.#######.#
#.#.............#.#.#...........#.#.....#.#...#.....#......
#########################################################..
