..#########
....#.....#
###.#####.#
#.#...#...#
#.###.###.#
#.......#.#
#######.#.#
#.#.#.....#
#.#.#.###.#
#.......#..
#########..
